NO textures/north.xpm
SO textures/south.xpm
WE textures/west.xpm
EA textures/east.xpm

F 123,45,67
C 10,20,30


111111111111111
100000000000001
101111111110001
100000000010001
101111101010001
100000001010001
111111101010001
100000001000001
10000000000S001
111111111111111