NO    textures/north.xpm
SO textures/south.xpm
WE       textures/west.xpm
EA textures/east.xpm

F 0,255,0
C 255,255,255

        111111111
        100000001
11111111100000001
10000000000000001
10000W00011111111
1000000001
1111111111