NO textures/north.xpm
SO textures/south.xpm
WE textures/west.xpm
EA textures/east.xpm

F 10,20,30
C 40,50,60

111111111
100000001
10N000S01
100000001
111111111