NO textures/north.xpm
SO textures/south.xpm
WE textures/west.xpm

F 10,20,30
C 40,50,60

111111
100001
10N001
100001
111111