NO textures/north.xpm
SO textures/south.xpm
WE textures/west.xpm
EA textures/east.xpm

F 256,0,0
C 20,20,20

111111
100001
10N001
100001
111111